11111111111
10001000001
10100010001
10001000101
11111111111